2:C1:C2
3:D4:F4
4:B5:B8
5:D7:H7

XA B C D E F G H
1. . 2 . . . . .
2. . 2 . . . . .
3. . . . . . . .
4. . . 3 3 3 . .
5. 4 . . . . . .
6. 4 . . . . . .
7. 4 . 5 5 5 5 5
8. 4 . . . . . .
