2:C4:D4
3:H1:H3
4:E6:H6
5:B1:F1

XA B C D E F G H
1. 5 5 5 5 5 . 3
2. . . . . . . 3
3. . . . . . . 3
4. . 2 2 . . . .
5. . . . . . . .
6. . . . 4 4 4 4
7. . . . . . . .
8. . . . . . . .
